*******************#
********************
********************
*****####*******#***
*****#**********#***
*****#**********#***
*****#**********#***
*****#**********#***
****************#***
**************###***
***###**************
********************
**************#*****
**************#*****
**************#*****
**************#*****
*****#********#*****
****###########*****
**************#*****
********************